XXXXX!!!!
X...XXXXX
X.#*****X
X.#X*.*XX
X.#$.X.X!
X.####.X!
XX.....X!
X..XXX.X!
X......X!
XXXXXXXX!
