XXXXXXXXXX!
X....X...XX
X..#......X
XX#X*X..X.X
X..X*#**X.X
X..XXXXX..X
X....X$..XX
X......#.X!
X..#*XXXXX!
XXXXXX!!!!!
